111111111 
101010101 
101010101 
101010101 
101010101
101010101
101011101
101010101
111011101